7,7
XXXXXGX
X--X--X
X-----X
XXXXX-X
X-----X
X--X-XX
XXXXXXX
